R    3000 5000
SO ./routing1.c
WE ./routing1.c
EA ./get_next_line.h
NO ./FILE WITH SPACE.c
S ./get_next_line.h
F  10,14,10
C  12,12,30

111111
100000111111111
1111100000000001
1000000001110001
1000000001110001    1
1000000001110001   1N1             1111111    111111    1111111   1111111    11    11
1111111111111111    1              1     1    1     1   1     1   1     1    11    11
                                   1111111    1111111   1111111   1111111    11111111 
11111                              1     1    1         1     1   1     1    11    11
10001   111111111111111111111      1     1    1         1     1   1     1    11    11
10001   100000000000000000001
10001   100000000000000000001
11111   100000000000000000001
10001   111111111111111111111
1111
