R    3000 5000
SO ./routing1.c
WE ./routing1.c
EA ./get_next_line.h
S ./get_next_line.c
NO ./readfile.c
F 10,14,10
C 12,12,30

    11111      1111111111      11111111
      11       100000000111111110000011
      11       100000000000000000000001
               100000000000000000000001
               100000000001111100000001     11111111111
      1        111110011111   1111001111111110000000001
               100000000001   1000000000000000000000001
               1000000000011111000000011111111111000001
               100000000001   100000001         100001
               10001000001   100000001          10111
               100011000001111100010001        11101111
               100000000000111000001001        10000001
               100011000000111000000001        10000001
               100000000000000000000001        100000001
111111111111111111111100000011111001111        1110000001
100000000000000000000000000010000000001         1000110001
100111111111111111111111111111111111111          1001100001
100111111111111                                   1110000001
100100000000001                                    11111111
100111111111101
100000000000001
111111111111111
111111
1000001
1000001
111111
