R  500 500
SO ./routing1.c
WE ./routing1.c
EA ./get_next_line.c
NO ./get_next_line.c
S  ./get_next_line.h
F  10,14,10
C  12,12,30

111111111111111111111111111111111111111111111111111111111111111111111111111111111111111111111111111111111111111111
100000111111111                                                                                                  1
1111100000000001                                                                                                  1
1000000001110001                                                                                                 1
1000000001110001    1                                                                                             1
1000000001110001   1N1             1111111    111111    1111111   1111111    11    11                            1
1000111111111111    1              1     1    1     1   1     1   1     1    11    11                             1
10001                              1111111    1111111   1111111   1111111    11111111                            1
10001                              1     1    1         1     1   1     1    11    11                             1
10001   111111111111111111111      1     1    1         1     1   1     1    11    11                            1
10001   100000000000000000001                                                                                     1
10001111100000000000000000001                                                                                    1
10000000000000000000000000001                                                                                     1
10001111111111111111111111111                                                                                    1
10001                                                                                                             1
111111111111111111111111111111111111111111111111111111111111111111111111111111111111111111111111111111111111111111
    
1111
1001
1111
